111111
100101
100101
100101
1100N1
111111