    111111111111111111111111111
    1100000110000000000001111111111111111111111111111
11111110110000011100010000000010000000000000000000011
10010000000000000000000010000000000111111111111111111
1111111110110000N11100001111111111111
1000000000110000011101111
11110111111111011100000011
1111011111111101110101001
1100000011010101110000001
100000000000000011000000111
10000000000000001101010001
110000011101010111110111111
1111011111110101110111101
11111 1111111111111 11111