    111111111111111111111111111
    110000011000000000000111111
111111    10110000011100010000000010000000000000000000011
100100000000000000000000100000000001
1111111110110000N1110000111
1000000000110000011101111
11110111111111011100000011
1111011111111101110101001
1100000011010101110000001
100000000000000011000000111
100000000          00000001101010010
110000011101010111110111111
1111011111110101110111101
11111 1111111111111 11111