    111111111111111111111111111111
    1111111111111111111111111111111111111111111111111111
11111111000001100000000000011111111111111111111111111111
1111111011000001110001000000001000000000000000000001111
11001000000000010000000001000000000011111111111111111111
1111111110110010N1110000000000000011111111
11000000000110100011100000000000000111111111111111
111101111111100101100000000000000111
111110111111101011101010000000011
111000000110101011100000000000011
11000000000000000110000000001111
110000000000000000001010000011
110000000000000000000000000011
1110000011101010111110111001111
11111011111110101110111101111
11111111111111111111111111111
11111 1111111111111 111111