1111111
101N101
1001001
1111111