 111111111111111111111111111111
 100110000011000000000000111111111111111111111111111111111
111111101100000111000100000000100000000000000000000111
1001000000000000000000001000000000011111111111111111111
1111111110110000N11100001111111111111
1000000000110000011101111
11110111111111011100000011
1111011111111101110101001
1100000011010101110000001
100000000000000011000000111
10000000000000001101010001
100000011101010111110111111
1011011111110101110111101
10111 1111111111111 11111
10111
1011
111