NO     images/wall_north.xpm
SO images/wall_south.xpm
WE images/wall_west.xpm

EA images/wall_east.xpm

F 220,100,0

C 225,30,0

11111111111
100000N0001
11111111111