11111111111111111111111
1001100000000000000001111111111111111111111111111
1000000100010000000000000000000000000000000000011
1000000100010000000000000000000000000000000000011
1110111100011100010000000010000000000000000000011
1000000000000000000010000000000111111111111111111
111110000W000011100001111111111111
1000000000000011101111
1000111100011110000001
1111100100010000000001
1000000100010000000001
1000000000000000000001
1000000000000000000001
1000000000000000000011111111111111111111111111
1111100000000000000010000000000000000000000001
1000000000000000000000000000000000000000000001
1000000000000000000000000000000000000000000001
1000000000000000000000000011110000000000000001
1000000000000000000000000000000000000011111111
1000000000000000000000000000000000000000001111
1000000000000000000011111111111111111111111111
1000000000000000000011111011110000000000000001
10000000000000000000000000000000000000000000011
10000000000000000000000000000000000000000000011111111111111
10000000000000000000000000000000000000000000000000000000001
10000000000000000000111111000000001111110000000000000111111
10000000000000000000111111111111111111000000000000011111111
10000000000000000000111110111100000000000000000000000000001
10000000001000000000000000000000000000000000000000011111111
11111100001110000000000000000000000000000000000000000000001
100010000001000000000000000000000000000000000011111111111111
100010000010000000011111111000000000000000000000011111111
100010000001000000000000000000000000000000000011111111111111
10001000001000000001000000000000000000000000000000000000001111
10001000000100000000000000000000000000000000000000000000000011
10001000001000000000000000000000000000000000000000000000001111
10001000001000000001000000000000000000000000000000000000001111
10001000000100000000000000000000000000000000000000000000000011
10001000001000000000000000000000000000000000000000000000001111
10001000001000000001000000000000000000000000000000000000001111
10001000000100000000000000000000000000000000000000000000000011
10001000001000000000000000000000000000000000000000000000001111
10001000001000000001000000000000000000000000000000000000001111
100010000000000000000000000000000000000000000000000000000011
10001000001000000000000000000000000000000000000000000000001111
100010000001000000000000000000000000000000000011111111111111
1000000010000010000000000000000000000000000000000000000000000011
1000000010000001000000000000000000000000000000000011111111111111
1000000010000010000000011111111111111111111111111111
1111010010000010000000001
1000000010000010000000001
1000000010000010000000001
1000000000000000000000001
1000000000000000000000001
1111011100000000000000001
1000000100000000000000001
1000000000000000000000001
1000000000000000000000001
1000000000000000000000001
1111011111111101110101001
1100000011111101110000001
1111111111111111111111111