NO     images/wall_north.xpm
SO images/wall_south.xpm
WE images/wall_west.xpm

EA images/wall_east.xpm

F 220,100,0

C 225,30,0



111111111111111111111
1000000100010000000011
1000000000000000000111111111
111110000W000011100011111111111111
1000000000000011101111
1000111100011110000001
1111100100010000000001
1000000100010000000001
1000000000000000000001
1000000000000000000001111
10001000000000000000001111
100000001000001000000111111
1000000010000010000000001
10000000100000100011111111
10000000000000000011111111
1000000000000000000000001
1000000000000000000000001
1111011100000000000000001
1000000100000000000000001
1000000000000000000000001
1000000000000000000000001
1000000000000000000000001
1111001111111101110101001
1100000011111101110000001
111111111  1111111111111111