
NO       images/wall_north.xpm
SO            images/wall_south.xpm
WE         images/wall_west.xpm
EA         images/wall_east.xpm

F          50,50,50
C           200  ,   30    , 5 

111111111
100000N01
111111111
