
NO       ./resources/walls/north.xpm
SO            ./resources/walls/south.xpm
WE         ./resources/walls/west.xpm
EA                            ./resources/walls/east.xpm

F          50  ,  50  ,  50   
C           255  ,   30    , 5 

        1111111111111111111111111
        1000000000110000000000001
        1011000001110000000000001
        1001000000000000000000001
111111111011000001110000000000001
100000000011000001110111111110111
111101111111110111000000000011
1111011111111101110101001000111
1100000011010101110000001000101
1000000000000000110000001000101
1000000000000000110101001000101
11100001110101011111011110N0111
11 10111 1110101 101111010001011
1 111111 1111111 1111111111110001
111111                11111111111111