
NO       ./resources/walls_2/north.xpm
SO            ./resources/walls_2/south.xpm
WE         ./resources/walls_2/west.xpm
EA                            ./resources/walls_2/east.xpm

F          50,50,50
C           200  ,   30    , 5 

11111
10N01
11111
