
NO       ./images/wall_north.xpm
SO            ./images/wall_south.xpm

F          50  ,  50  ,  50   
C           255  ,   30    , 5 
EA                            ./images/wall_east.xpm

WE         ./images/wall_west.xpm

        1111111111111111111111111
        1000000000110000000000001
        1011000001110000000000001
        100100000000000000N000001
111111111011000001110000000000001
100000000011000001110111111111111
11110111111111011100000000001
11110111111111011101010010001
11000000110101011100000010001
111111111111111111111111111111
111111111111111111111111111111
10000000000000001100000010001
10000000000000001101010000001
110000011101010111110111100011
11110111 1110101 101111010001
11111111 1111111 111111111111