
NO       ./images/wall_north.xpm
SO            ./images/wall_south.xpm
WE         ./images/wall_west.xpm
EA                            ./images/wall_east.xpm

F          20,50,70
C           90  ,   100    , 190 

111111111111111
100000000000001
100100010000001
100000001010001
110N01000000001
100100001010011
101000000000101
100100001010001
101000000000001
100101010010001
111010010100101
11 101101010001
11 111111111111