
NO       ./images/wall_north.xpm
SO            ./images/wall_south.xpm

F          20 ,  50    ,70     

WE         ./images/wall_west.xpm
C               90  ,   100    , 190 

EA                  ./images/wall_east.xpm



        1111111111111111111111111
        1000000000110000000000001
        1011000001110000000000001
        1001000000000000000000001
1111111110011000001110000000000001
100000E00011000001110111111111111
11110111111101011 100000000001
11110111111101011101010010001
11000000000000000000000010001
111111111011011101111101111111
111111111011011101111101111111
10000000000000001100000010001
10000000000000000001010010001
110000011101010111110111000011
11110111 1110101 101111010001
11111111 1111111 111111111111